000000000001111111100000000000
001111000001000000100001111100
000001000011110000100001000100
000001000011010000100001000100
000001000011010000111111100100
000001000011111111100000100100
000001000010010000100000100100
000001111111110000100000100100
000000000010000000100000100100
000000000010000000100000100100
000000000011111111100000100110
011111100010000000041114011110
010000100010000000010000100110
010000100011110000010000100110
010000100010010000010000111110
010000100010010114011100000010
011111111110010100000100000010
000000100000010111140100000010
001111111111110001000100000010
001000100000000001000100011010
001111111111111001000100011010
011100100000001005000100011010
010100100000001000000100011110
010100100000001041111100001000
010114000000001010000000004000
010000111111111010021111000010
010000000000000040000000411010
011111111111111404111111001010
000000000000000040000001001010
000000000000000011111111001110
